             .. 
            |  |
            |  |
            |  |
 ___________|  |____________
|                           |
|                           |
|            ____           |
|           | 🗡️  |              
|           |____|          |
|                           |
|                           |
|___________________________|
