 ___________________________
|                           |
|                           |
|                           |
 :            🧟              
|                           |
|                           |
|                           |
|____________   ____________|
